CHROM,ID,START,END,SVLEN,ALT,SVTYPE
1,1,372404,372671,-267,<DEL>,DEL
1,2,1160224,1161226,-1002,<DEL>,DEL
1,3,1430265,1431037,-772,<DEL>,DEL
1,4,2029681,2031704,-2023,<DEL>,DEL
1,5,2657405,2657924,-519,<DEL>,DEL
1,6,2788420,2800694,-12274,<DEL>,DEL
1,7,2951234,2951429,-195,<DEL>,DEL
1,8,3023470,3024291,-821,<DEL>,DEL
1,9,3062001,3063654,-1653,<DEL>,DEL
1,10,3090043,3090311,-268,<DEL>,DEL
1,11,3328908,3333497,-4589,<DEL>,DEL
1,12,3719920,3720642,-722,<DEL>,DEL
1,13,3780766,3785720,-4954,<DEL>,DEL
1,14,3935847,3936315,-468,<DEL>,DEL
1,15,4171392,4171521,-129,<DEL>,DEL
1,16,4197026,4198783,-1757,<DEL>,DEL
1,17,5044203,5045530,-1327,<DEL>,DEL
1,18,5679265,5681878,-2613,<DEL>,DEL
1,19,6262601,6263386,-785,<DEL>,DEL
1,20,6538414,6543543,-5129,<DEL>,DEL
1,21,6657151,6660377,-3226,<DEL>,DEL
1,22,6874392,6874421,-29,<DEL>,DEL
1,23,6912032,6912464,-432,<DEL>,DEL
1,24,7254958,7257227,-2269,<DEL>,DEL
1,25,7352929,7365197,-12268,<DEL>,DEL
1,26,7903134,7903439,-305,<DEL>,DEL
1,27,7969333,7974599,-5266,<DEL>,DEL
1,28,8189961,8190559,-598,<DEL>,DEL
1,29,8729223,8733578,-4355,<DEL>,DEL
1,30,8927598,8933223,-5625,<DEL>,DEL
1,31,9004829,9015712,-10883,<DEL>,DEL
1,32,9004830,9015764,-10934,<DEL>,DEL
1,33,10060624,10060880,-256,<DEL>,DEL
1,34,10119688,10119705,-17,<DEL>,DEL
1,35,10152769,10156803,-4034,<DEL>,DEL
1,36,10456758,10456853,-95,<DEL>,DEL
1,37,10949856,10950912,-1056,<DEL>,DEL
1,38,12183404,12183996,-592,<DEL>,DEL
1,39,12502442,12502662,-220,<DEL>,DEL
1,40,16162972,16163009,-37,<DEL>,DEL
1,41,18338682,18340258,-1576,<DEL>,DEL
1,42,19496292,19498170,-1878,<DEL>,DEL
1,43,19898228,19898484,-256,<DEL>,DEL
1,44,20958891,20959656,-765,<DEL>,DEL
1,45,23211639,23212707,-1068,<DEL>,DEL
1,46,23280424,23281685,-1261,<DEL>,DEL
1,47,24776629,24776896,-267,<DEL>,DEL
1,48,25159042,25163486,-4444,<DEL>,DEL
1,49,25261932,25261966,-34,<DEL>,DEL
1,50,25407085,25407159,-74,<DEL>,DEL
1,51,25718486,25718735,-249,<DEL>,DEL
1,52,26169343,26171566,-2223,<DEL>,DEL
1,53,26169374,26171582,-2208,<DEL>,DEL
1,54,26306956,26307503,-547,<DEL>,DEL
1,55,26366606,26371668,-5062,<DEL>,DEL
1,56,26740752,26740764,-12,<DEL>,DEL
1,57,28526860,28527715,-855,<DEL>,DEL
1,58,28856390,28856755,-365,<DEL>,DEL
1,59,28920618,28921012,-394,<DEL>,DEL
1,60,29774259,29775138,-879,<DEL>,DEL
2,61,482856,483097,-241,<DEL>,DEL
2,62,2149938,2150864,-926,<DEL>,DEL
2,63,2179204,2179367,-163,<DEL>,DEL
2,64,7777042,7784329,-7287,<DEL>,DEL
2,65,8242295,8242697,-402,<DEL>,DEL
2,66,8704457,8704482,-25,<DEL>,DEL
2,67,8704459,8704506,-47,<DEL>,DEL
2,68,8997670,8997927,-257,<DEL>,DEL
2,69,9633547,9635122,-1575,<DEL>,DEL
2,70,9738925,9739123,-198,<DEL>,DEL
2,71,9807777,9808378,-601,<DEL>,DEL
2,72,9807805,9808384,-579,<DEL>,DEL
2,73,9927691,9932563,-4872,<DEL>,DEL
2,74,10070094,10070978,-884,<DEL>,DEL
2,75,11327263,11329061,-1798,<DEL>,DEL
2,76,11436245,11442614,-6369,<DEL>,DEL
2,77,11981724,11983969,-2245,<DEL>,DEL
2,78,12149571,12150035,-464,<DEL>,DEL
2,79,13101811,13102359,-548,<DEL>,DEL
2,80,13239447,13239756,-309,<DEL>,DEL
2,81,13421908,13426567,-4659,<DEL>,DEL
2,82,13421900,13426624,-4724,<DEL>,DEL
2,83,13515483,13515805,-322,<DEL>,DEL
2,84,13906667,13908719,-2052,<DEL>,DEL
2,85,14788631,14789358,-727,<DEL>,DEL
2,86,14858767,14860843,-2076,<DEL>,DEL
2,87,14934706,14934980,-274,<DEL>,DEL
2,88,15566810,15568060,-1250,<DEL>,DEL
2,89,15595120,15597394,-2274,<DEL>,DEL
2,90,15972311,15972571,-260,<DEL>,DEL
2,91,16125659,16126526,-867,<DEL>,DEL
2,92,16379571,16380902,-1331,<DEL>,DEL
2,93,16417650,16418100,-450,<DEL>,DEL
2,94,16625760,16626820,-1060,<DEL>,DEL
2,95,16625740,16626823,-1083,<DEL>,DEL
2,96,17203818,17203828,-10,<DEL>,DEL
2,97,17257597,17258106,-509,<DEL>,DEL
2,98,17676952,17676973,-21,<DEL>,DEL
2,99,17924325,17924591,-266,<DEL>,DEL
2,100,19468143,19468573,-430,<DEL>,DEL
2,101,19513378,19513556,-178,<DEL>,DEL
2,102,19581163,19581403,-240,<DEL>,DEL
3,103,129161,130750,-1589,<DEL>,DEL
3,104,560992,560997,-5,<DEL>,DEL
3,105,1143156,1143564,-408,<DEL>,DEL
3,106,1800821,1801047,-226,<DEL>,DEL
3,107,3189711,3189721,-10,<DEL>,DEL
3,108,3278144,3278415,-271,<DEL>,DEL
3,109,3538055,3539114,-1059,<DEL>,DEL
3,110,3630931,3631176,-245,<DEL>,DEL
3,111,3716340,3717219,-879,<DEL>,DEL
3,112,3987672,3988438,-766,<DEL>,DEL
3,113,4494776,4495031,-255,<DEL>,DEL
3,114,4856663,4862401,-5738,<DEL>,DEL
3,115,4927416,4932452,-5036,<DEL>,DEL
3,116,4977269,4978012,-743,<DEL>,DEL
3,117,5151925,5156696,-4771,<DEL>,DEL
3,118,5569072,5569092,-20,<DEL>,DEL
3,119,6373646,6379186,-5540,<DEL>,DEL
3,120,6486321,6487246,-925,<DEL>,DEL
3,121,9226632,9231376,-4744,<DEL>,DEL
3,122,9861865,9862124,-259,<DEL>,DEL
3,123,9981926,9982213,-287,<DEL>,DEL
3,124,11463084,11463110,-26,<DEL>,DEL
3,125,14193407,14203967,10560,<DUP>,DUP
3,126,14193494,14203965,10471,<DUP>,DUP
3,127,16508068,16508071,-3,<DEL>,DEL
3,128,16787575,16788015,-440,<DEL>,DEL
3,129,17853913,17854478,-565,<DEL>,DEL
3,130,18206970,18207181,-211,<DEL>,DEL
3,131,18243254,18244653,-1399,<DEL>,DEL
3,132,18343524,18343814,-290,<DEL>,DEL
3,133,19121440,19121495,-55,<DEL>,DEL
3,134,19577850,19578428,-578,<DEL>,DEL
3,135,19577820,19578426,-606,<DEL>,DEL
3,136,19776682,19779668,-2986,<DEL>,DEL
3,137,19802580,19803357,-777,<DEL>,DEL
3,138,20305287,20309826,-4539,<DEL>,DEL
3,139,20617702,20618131,-429,<DEL>,DEL
3,140,20685604,20686817,-1213,<DEL>,DEL
3,141,20786394,20788446,-2052,<DEL>,DEL
3,142,21263343,21263637,-294,<DEL>,DEL
3,143,21424780,21425340,-560,<DEL>,DEL
3,144,21471434,21472731,-1297,<DEL>,DEL
3,145,22024473,22024484,-11,<DEL>,DEL
3,146,22695566,22700523,-4957,<DEL>,DEL
3,147,23085541,23086089,-548,<DEL>,DEL
3,148,23124397,23127803,-3406,<DEL>,DEL
3,149,23359599,23359624,-25,<DEL>,DEL
4,150,799674,799954,-280,<DEL>,DEL
4,151,1063366,1064185,-819,<DEL>,DEL
4,152,5470923,5472407,-1484,<DEL>,DEL
4,153,5822417,5827303,-4886,<DEL>,DEL
4,154,6588709,6593821,-5112,<DEL>,DEL
4,155,7524715,7526698,-1983,<DEL>,DEL
4,156,14514849,14516231,-1382,<DEL>,DEL
4,157,8327632,8329725,-2093,<DEL>,DEL
4,158,8724530,8724918,-388,<DEL>,DEL
4,159,9980878,9982101,-1223,<DEL>,DEL
4,160,10491627,10493177,-1550,<DEL>,DEL
4,161,10934619,10935430,-811,<DEL>,DEL
4,162,11206784,11210979,-4195,<DEL>,DEL
4,163,11412904,11413205,-301,<DEL>,DEL
4,164,12306805,12309537,-2732,<DEL>,DEL
4,165,13316601,13317076,-475,<DEL>,DEL
4,166,13619875,13637350,-17475,<DEL>,DEL
4,167,13778034,13781598,-3564,<DEL>,DEL
4,168,14031554,14031966,-412,<DEL>,DEL
4,169,14280164,14288309,-8145,<DEL>,DEL
4,170,15012482,15014864,-2382,<DEL>,DEL
4,171,15397744,15398694,-950,<DEL>,DEL
4,172,15922831,15924048,-1217,<DEL>,DEL
4,173,16232531,16232803,-272,<DEL>,DEL
4,174,16617608,16618448,-840,<DEL>,DEL
4,175,16920937,16921192,-255,<DEL>,DEL
4,176,18087194,18087443,-249,<DEL>,DEL
4,177,18323321,18323334,-13,<DEL>,DEL
5,178,64768,71223,-6455,<DEL>,DEL
5,179,250070,251120,-1050,<DEL>,DEL
5,180,1065394,1067894,-2500,<DEL>,DEL
5,181,1180509,1181404,-895,<DEL>,DEL
5,182,1515163,1516312,-1149,<DEL>,DEL
5,183,2105881,2108050,-2169,<DEL>,DEL
5,184,2257335,2262951,-5616,<DEL>,DEL
5,185,4242267,4242743,-476,<DEL>,DEL
5,186,5007976,5008572,-596,<DEL>,DEL
5,187,5254065,5254098,-33,<DEL>,DEL
5,188,5288313,5289151,-838,<DEL>,DEL
5,189,5423122,5423602,-480,<DEL>,DEL
5,190,5580330,5580568,-238,<DEL>,DEL
5,191,5643928,5646858,-2930,<DEL>,DEL
5,192,6205806,6212629,-6823,<DEL>,DEL
5,193,6872870,6873296,-426,<DEL>,DEL
5,194,7956609,7957040,-431,<DEL>,DEL
5,195,8716465,8723805,-7340,<DEL>,DEL
5,196,8781755,8782238,-483,<DEL>,DEL
5,197,8896645,8897764,-1119,<DEL>,DEL
5,198,9069308,9070677,-1369,<DEL>,DEL
5,199,13755346,13759391,-4045,<DEL>,DEL
5,200,15431881,15432723,-842,<DEL>,DEL
5,201,18258343,18260267,-1924,<DEL>,DEL
5,202,19670802,19672841,-2039,<DEL>,DEL
5,203,19930211,19931556,-1345,<DEL>,DEL
5,204,20803358,20804672,-1314,<DEL>,DEL
5,205,22096428,22097015,-587,<DEL>,DEL
5,206,22463655,22464204,-549,<DEL>,DEL
5,207,23431541,23432883,-1342,<DEL>,DEL
5,208,23774315,23775706,-1391,<DEL>,DEL
5,209,24344084,24345548,-1464,<DEL>,DEL
5,210,24586640,24587055,-415,<DEL>,DEL
5,211,24703478,24703888,-410,<DEL>,DEL
5,212,24734798,24734933,-135,<DEL>,DEL
5,213,24798023,24801364,-3341,<DEL>,DEL
5,214,24970899,24971206,-307,<DEL>,DEL
5,215,25268167,25268223,-56,<DEL>,DEL
5,216,26233091,26233533,-442,<DEL>,DEL
5,217,26483020,26485399,-2379,<DEL>,DEL
mitochondria,218,9,366918,366909,<DUP>,DUP
chloroplast,219_1,47,NA,NA,[chloroplast:84171[N,BND
chloroplast,219_2,84171,NA,NA,[chloroplast:47[N,BND
chloroplast,220_1,10,NA,NA,[chloroplast:84177[N,BND
chloroplast,220_2,84177,NA,NA,[chloroplast:10[N,BND
chloroplast,221_1,10,NA,NA,[chloroplast:84209[N,BND
chloroplast,221_2,84209,NA,NA,[chloroplast:10[N,BND
chloroplast,222,9,154471,154462,<DUP>,DUP
1,223_1,27435344,NA,NA,]5:17605840]N,BND
5,223_2,17605840,NA,NA,N[1:27435344[,BND
2,224_1,10341,NA,NA,N[3:14193784[,BND
3,224_2,14193784,NA,NA,]2:10341]N,BND
2,225_1,10368,NA,NA,N[3:14193782[,BND
3,225_2,14193782,NA,NA,]2:10368]N,BND
2,226_1,10366,NA,NA,N[3:14194695[,BND
3,226_2,14194695,NA,NA,]2:10366]N,BND
2,227_1,10372,NA,NA,N[3:14194459[,BND
3,227_2,14194459,NA,NA,]2:10372]N,BND
4,228_1,438535,NA,NA,[chloroplast:35644[N,BND
chloroplast,228_2,35644,NA,NA,[4:438535[N,BND
